              
    EA                ./path_to_the_east_texture                
NO      ./path_to_the_north_texture 
WE    ./path_to_the_west_texture  
F                220,54,0   
C 255,30,54
SO ./path_to_the_south_texture



1111111111111111
10000000000001
1111111111111111




   1    11111111111111111111111111
  1N1    1000000000110000000000001
   1    1011000001110000000000001
        1001000000000000000000001   1
111111111011000001110000000000001  101
100000000011000001110111111111111   1
11110111111111011100000010001
11110111111111011101010010001
11000000110101011100000010001
10000000000000001100000010001
1000000000000000110100010001
110000011101010111110111100
11110111 1110101 101111010001
11111111 1111111 111111111111