
NO  textures/North.xpm
                SO textures/South.xpm                 
WE             textures/West.xpm             
EA    textures/East.xpm

F 20,61,59

C                   105,199,240


11111           
1N001
10001                
10001
10001
10001
11001               
10001
10001
10001
10001
100011111
11111   111






     
      
       
        
         
          
           
