
NO textures/North.xpm
SO textures/South.xpm
WE textures/West.xpm
EA textures/East.xpm

F 61,61,59
C 105,199,240

111111111111111111111111111111111111111111111111111111111111111
                                                        10000N1
                                                        1111111