NO textures/North.xpm
SO textures/South.xpm
WE textures/West.xpm
EA textures/East.xpm

F 50,168,82
C 222,214,62

111111111111111111111
1N000000001000100011111
111111111000100010001
111111111111111111111